35  122  0   0
23 29 29 29 29 29 29 29 29 29 29 29 29 29 29 29 29 0 0 29 29 29 29 29 29 29 29 29 29 29 29 29 29 29 32
31 0 0 0 0 0 0 0 0 0 0 0 0 0 0 0 51 0 0 0 0 0 0 0 0 0 0 0 0 0 0 0 0 0 32
31  0 0 0 0 0 0 0 0 0 0 0 0 0 0 0 0 0 0 0 0 0 0 0 0 0 0 0 0 0 0 0 52 0 32
31  0 0 0 0 0 0 0 0 0 0 0 0 0 0 0 0 0 0 0 0 0 51 0 0 0 0 0 0 53 0 0 0 0 32
31  0 0 0 0 0 0 0 0 0 0 0 0 0 0 0 0 0 0 0 0 0 0 0 0 0 0 0 0 54 0 0 0 0 32
31  0 0 0 0 0 0 0 0 0 0 0 0 0 0 0 0 0 0 0 0 0 0 0 0 0 0 0 0 0 0 0 0 0 32
31  0 0 0 0 0 0 0 0 0 0 0 0 53 0 0 0 0 0 0 0 0 53 0 0 0 51 0 0 0 0 52 0 0 32
1 0 0 0 0 0 0 0 0 0 0 0 0 0 0 0 52 0 0 0 0 0 54 0 0 0 0 0 0 0 0 0 0 0 32
31 0 0 0 0 0 0 0 0 0 0 0 0 0 0 0 0 0 0 0 0 0 0 0 0 0 0 0 0 0 0 0 0 0 32
33 29 29 29 29 29 29 29 29 33  0 0  0   0  0  0 0 0 0 0 0 0 0 0 0 0 0 0 0 0 0 0 0 0 33 
31 0 0 0  0  0  0  0  0 33 33 33 33 33 33 33 33     0 33 33  29 29 29 29 29 29 29 29 29 29 29 29 29 29 33 
31 0 0 32 33 33 33 0  32 33 29 29 29 29 29 29 29 0 29  33  0 0 0 0 0 0 0 0 0 0 0 0 0 0 32
31 0 0 32 33 33 33 0  32 31 0  0  0  0  0  0   0 0   0     33  0 0 0 1 1 1 1 1 1 1 1 0 0 0 32
31 0 0 32 33 33 33 0  32 31 0  0  32 33 33 33 31    0  0 33  0 0 0 1 1 1 1 1 1 1 1 0 0 0 32
31 0 0 32 33 33 33 0  32 31 0  0  32 33 33 33 31   0    0 23 0 0 0 1 1 1 1 1 1 1 1 0 0 0 32
31 0 0 32 29 29 29 0  32 31 0  0  32 33 33 33 31   0  0 0 0 0 0 0 0 0 0 0 0 0 0 0 0 0 32
31 0 0  32 0  0  0  0  32 31 0  0  32 33 33 33 31    0  0 29 29 29 29 29 29 29 29 29 29 29 29 29 29 29 29
31 0 0 32 33 33 31 0  32 31 0  0  32  33 33 33 31    0  0 0 0 0 0 0 0 0 0 0 0 0 0 0 0 0 32
31 0 0 32 33 33 31  0  32 31 0  0  32 33 33 33 31    0  52 0 0 53 0 0 0 0 0 0 0 0 52 0 0 0 32
31 0 0 32 33 33 31  0  32 31 0  0  32 33 33 33 31     0  0 0 0 0 0 0 0 0 53 0 0 0 0 0 0 0 32
31 0 0 32 33 33 31  0  29 29 0  0  32 33 33 33 31      0  52 0 0 0 52 0 0 0 0 0 0 0 0 0 0 0 32
31 0 0 32 33 33 31 0  0 0 0 0      32 33 33 33 31    0    0  0 0 0 0 0 0 0 0 53 0 0 52 0 0 0 32
31 0 0 32 33 33 31  0  0 0   0 0   32  33 33 33 31    0    0  0 0 0 0 52 0 0 0 0 0 0 0 0 0 0 32
31 0 0 32 33 33 33 33 29 29 29 29  33 33 33 33 31    0  52 0 0 0 0 0 0 0 0 0 0 0      0 0 53 0 32
31 0 0 29 29 29 29 29 0 0 0 0      32  33 33 33 31     0 0    0  0  0 0 0 0 52 0 0 0 0   0 0 0 0 32
31 0 0 0  0 0 0 0 0     0 0 0     32 33   33 33 31       53 0 0 0   0  0 53 0 0 0 0 0 0 0 0 0 0 32
33  33 
33 33 33 33 33 31  0 0 0 0   32 33 33 33 31 0   0 0  0 0  0 0 0 0 0 0 0 0        0 0 0 0 32
33  33 33 33 33 33 33 33  33 33 33 33   33 33 33 33 31 0   0 0  0 0  0 0 0 0 0 0 0 0 0 0 0 0 32
33  33 33 33 33 33 33 33  33 33 33 33   33 33 33 33 31 0   0 0 43 39 39 39 39 39 39 39 39 39 39 39 35 0 32
33  33 33 33 33 33 33 33  33 33  33 33 33 33 33 33 31 0  0 0 41 18 18 18 18 18 18 18 18 18 18 18 18 0 32
33  33 33 33 33 33 33 33  33 33  33 33 33 33 33 33 31  0  0   0 41 18 18 18 18 18 18 18 18 18 18 18 42 0 32
33  33 33 33 33 33 33  33  33 33  33 33 33 33 33 33 31  0  0  0 41 18 18 18 18 18 18 18 18 18 18 18 42 0 32
33  33 33 33 33 33 33 33 33     33  33 33 33 33 33 33 31  0  0 0 41 18 18 18 18 18 18 18 18 18 18 18 42 0 32
33  33 33 33 33 33  33  33   33  33  31 33 33 33 33 33 31 0 0 0  41 18 18 18 18 18 18 18 18 18 18 18 42 0 32
33  33 33 33 33 33 33 33 33 33 33 33 33 33 33 33 31  0   0 0 41 18 18 18 18 18 18 18 18 18 18 18  42 0 32
33  33 33 33 33 33 33 33 33 33 33 33 33 33 33 33 31  0   0 0 41 18 18 18 18 18 18 18 18 18  18 18 42 0 32
33  33 33 33 33  33  33  33  33  33  33  33  33  33  33  33 31  0  0 0 34 38 38 38 38 38 38 38 38 38 38 38 36 0 32
33  33 33 33 33  33  33  33  33  33  33  33  33  33  33  33  31  0 0 0 0 0 0 0 0 0 0 0 0 0 0 0 0 0 32
33  33 33 33 33  33  33  33  33 33  33  33  33  33  33  33  31  0  0 0 0 0 0 0 0 0 0 0 0 0 0 0 0 0 32
33 33 33 33 33 33 33 33 33 33 33 33 33 33 33 33 31  0  0  0  0  0  0  0  0  0  0  0  0  0  0  0  0  0 32
33 88    33	29  29  33  29	29  29 29  29	33	0 33 33	33 33 33 33	 33	33 33 33 33	33 33 33 33	33 33 33 33	33 33 33
91	88	88  88	88	88	88	88	88	88	88	88	88	88	88	88	88	88	88	88	88	88	88	88	88	88	88	88	88	88	88	88	88	88	88	 
91	8	88  88	88	88	88	88	88	88	88	88	88	88	88	88	88	88	88	88	88	88	88	88	88	88	88	88	88	88	88	88	88	88	88
91	8	88  88	88	88	88	88	88	88	88	88	88	88	88	88	88	88	88	88	88	88	88	88	88	88	88	88	88	88	88	88	88	88	88	
91	8	88  88	88	88	88	88	88	88	88	88	88	88	88	88	88	88	88	88	88	88	88	88	88	88	88	88	88	88	88	88	88	88	88	 
91	8	88  88	88	88	88	88	88	88	88	88	88	88	88	88	88	88	88	88	88	88	88	88	88	88	88	88	88	88	88	88	88	88	88
91	8	88  88	88	88	88	88	88	88	88	8	8	88	88	88	88	88	88	88	88	88	88	88	88	88	88	88	88	88	88	88	88	88	88	 
91	8	8	8	8	88	8	8	8	8	88	8	8	8	8	8	8	88	88	88	88	88	88	88	88	88	88	88	88	88	88	88	88	88	88
91	8	88	88	8	87	8	88	88	8	88	88	88	88	88	88	8	89	88	88	88	88	88	88	88	88	88	8	88	88	88	88	88	88	88
91	8	88	88	8	8	8	88	8	8	88	8	8	8	8	8	8	8	8	8	88	88	88	88	88	88	88	8	88	88	88	88	88	88	88
91	8	88	88	88	88	88	88	8	88	88	8	88	88	88	88	88	88	88	8	88	88	88	88	88	88	88	8	88	88	88	88	88	88	88
91	8	88	88	88	88	88	8	8	88	88	8	8	8	88	88	88	88	88	8	88	88	88	88	88	87	88	8	88	87	87	88	88	88	88
91	8	88	8	8	8	88	8	88	88	88	88	88	8	88	88	88	88	88	8	88	88	88	88	8	8	8	8	8	8	8	8	88	88	88
91	8	88	88	88	8	88	8	8	8	88	88	88	8	88	88	88	88	88	8	88	88	88	88	88	8	88	8	88	88	88	8	88	88	88
91	8	89	87	88	8	89	88	88	8	89	88	88	8	88	88	88	8	8	8	88	87	87	87	88	8	88	8	88	88	88	8	88	88	88
91	8	8	8	88	8	8	8	8	8	8	8	8	8	88	88	88	8	88	88	88	8	8	8	8	8	88	8	88	8	8	8	88	88	88
91	8	8	8	88	88	88	88	88	88	88	87	88	88	88	88	88	8	88	88	88	8	88	88	88	88	88	8	88	88	88	88	88	88  88
88	88	88	8	88	88	87	87	87	88	8	8	8	8	88	88	88	8	8	88	88	8	88	88	88	88	8	8	88	88	88	88	88	88	88
88	88	88	8	88	8	8	8	8	88	8	87	88	8	92	88	88	88	8	88	88	8	88	88	88	88	88	88	88	88	88	88	88	88	88
88	88	88	8	88	8	88	88	8	88	8	8	92	8	89	87	88	88	8	88	88	8	88	88	88	8	8	8	8	8	88	88	88	88	88
88	88	88	8	8	8	88	88	8	88	88	8	92	8	8	8	88	88	8	8	8	8	89	87	87	8	88	88	88	8	8	88	88	88	88
88	88	88	88	88	88	88	88	8	88	88	8	88	88	88	8	92	88	88	88	88	8	8	8	8	8	88	88	88	8	88	88	88	88	88
88	88	88	88	88	88	88	88	8	8	87	8	88	88	91	8	92	88	88	87	87	87	88	88	88	88	88	88	88	8	8	88	88	88	88
88	88	88	88	88	88	88	88	88	8	8	8	88	88	91	8	92	88	91	8	8	8	92	88	88	88	88	88	88	8	88	88	88	88	88
88	88	88	88	88	88	88	88	88	88	88	88	88	88	91	8	92	88	91	8	88	8	92	88	88	87	87	87	87	8	88	88	88	88	88
88	88	88	88	88	88	88	88	88	88	88	88	88	88	91	8	92	88	91	8	88	8	92	88	88	8	8	8	8	8	88	88	88	88	88
88	88	88	88	88	88	88	88	88	88	88	88	88	88	91	8	8	88	91	8	88	8	89	8	88	88	88	8	88	88	88	88	88	88	88
88	88	88	88	88	88	88	88	88	88	88	88	88	88	88	88	8	92	91	8	88	8	8	8	92	8	88	88	87	88	88	88	88	88	88
88	88	88	88	88	88	88	88	88	88	88	88	88	88	88	91	8	92	91	8	88	88	88	8	92	8	88	88	8	88	87	87	88	88	88
88	88	88	88	88	88	88	88	88	88	88	88	87	87	87	88	8	92	91	8	88	88	91	8	92	8	8	8	8	8	8	8	88	88	88
88	88	88	88	88	88	88	88	88	88	88	88	8	8	8	8	8	88	91	8	88	88	88	8	92	8	88	88	8	88	88	88	88	88	88
88	88	88	88	88	88	88	88	88	88	88	91	8	88	88	87	87	87	91	8	88	8	8	8	92	8	88	88	8	88	88	88	88	88	88
88	88	88	88	88	88	88	88	88	88	88	91	8	89	88	8	8	8	8	8	88	8	92	88	88	8	88	88	8	88	8	8	8	8	88
88	88	88	88	88	88	88	88	88	88	88	88	8	8	8	8	88	88	88	88	88	8	92	88	88	8	88	88	8	88	8	88	88	88	88
88	88	88	88	88	88	88	88	88	88	88	88	88	88	88	8	88	88	88	88	91	8	92	88	88	88	88	88	8	88	8	8	8	88	88
88	88	88	88	88	88	88	88	88	88	88	88	88	88	91	8	8	8	88	88	91	8	89	87	87	87	87	88	8	88	88	88	8	88	88
88	88	88	88	88	88	88	88	88	88	88	88	88	88	91	8	88	88	88	88	88	8	8	8	8	8	8	8	8	88	88	88	8	88	88 
88	88	88	88	88	88	88	88	88	88	88	88	88	88	88	8	88	8	8	8	88	87	87	87	87	87	87	88	8	88	88	88	8	88	88
88	88	88	88	88	88	88	88	88	88	88	88	88	88	88	88	88	8	88	8	8	8	8	8	8	8	8	8	8	88	88	88	8	88	88
88	88	88	88	88	88	88	88	88	88	88	88	88	88	88	88	88	8	88	88	8	88	8	88	88	88	88	88	88	88	88	88	8	8	92
88	88	88	88	88	88	88	88	88	88	88	88	88	88	88	88	88	8	88	88	8	88	8	88	88	88	88	88	88	88	88	88	88	8	92
88	88	88	88	88	88	88	88	88	88	88	88	88	88	88	88	88	8	88	88	8	88	8	88	88	88	88	88	88	88	8	88	88	8	92
88	88	87	87	87	87	87	87	87	87	88	88	88	88	88	8	8	8	88	88	88	88	8	89	88	88	88	88	88	88	8	88	88	8	92
91	8	8	8	8	8	8	8	8	8	8	88	88	88	88	8	89	88	88	88	88	88	8	8	8	8	8	8	8	8	8	88	88	8	92
91	8	88	88	88	88	88	88	88	88	8	88	88	88	88	8	8	8	88	88	88	88	88	88	88	88	88	88	88	88	88	88	88	8	92
91	8	88	88	88	87	87	87	88	88	8	88	88	88	88	88	88	8	88	88	88	88	88	88	88	88	88	88	88	88	88	88	88	8	88
91	8	88	88	8	8	8	8	8	88	8	88	88	88	88	88	88	8	8	88	88	88	88	88	88	88	88	88	88	88	88	88	8	8	92
91	8	88	88	8	88	88	88	8	88	8	88	88	88	88	88	88	88	8	88	88	88	88	88	88	88	88	88	88	88	88	88	88	8	92
91	8	88	88	8	88	88	88	8	88	8	88	88	88	88	88	88	88	8	88	88	88	8	8	8	8	8	8	88	88	88	88	88	88	88
91	8	88	88	8	88	88	88	8	88	8	89	87	87	87	87	87	88	8	88	88	88	8	88	88	88	88	8	88	88	88	88	88	8	88
91	8	88	88	8	88	88	88	8	88	8	8	8	8	8	8	8	8	8	88	88	88	8	88	8	8	8	8	88	88	88	88	88	8	92
91	8	88	88	8	88	88	88	8	89	88	88	88	88	88	88	88	88	88	88	88	88	8	88	8	88	88	88	88	88	88	88	88	8	92
91	8	88	88	8	88	88	88	8	8	8	88	88	88	88	88	88	88	88	88	88	88	8	88	8	8	8	88	8	8	8	8	88	8	92
91	8	88	88	8	88	88	88	88	88	8	8	8	88	88	88	88	88	88	88	88	88	8	88	88	88	8	88	8	88	88	8	88	8	92
91	8	88	88	8	88	8	8	8	89	88	88	8	88	88	88	88	88	88	88	88	88	8	88	88	88	8	8	8	88	88	8	8	8	92
91	8	88	88	8	88	8	88	8	8	8	88	8	88	87	88	88	88	88	88	88	88	8	89	88	88	88	88	88	88	88	8	88	88	88
91	8	88	88	8	8	8	88	88	88	8	88	8	88	8	8	8	88	88	88	88	88	8	8	8	8	8	8	88	88	8	8	88	88	91
91	8	88	88	8	88	88	87	87	88	8	88	8	88	8	88	8	88	88	88	88	88	88	88	88	88	8	8	88	88	8	88  88	88	91	
8
91	8	88	91	8	8	8	8	8	8	88	8	88	8	88	8	8   88	88  88  88	88	88	88	88	88	8	88	88	8	88	88	88	88
91	8	89	87	87	87	87	87	87	87	87	88	8	88	8	88	88	8	88	88	88	88	88	88	88	88	8	8	88	8	8	88	88	88
91	8	8	8	8	8	8	8	8	8	8	8	8	8	8	8	88	88	8	88	88	8	8	8	88	88	88	8	88	88	8	8	88	88	88
88	88	8	88	88	88	88	88	88	88	88	88	88	88	8	88	8	8	8	88	88	8	92	8	8	8	88	8	88	88	8	8	88	88	88
88	88	8	89	87	87	87	87	87	87	87	87	87	88	8	88	8	88	88	88	88	8	92	88	88	8	88	8	88	88	8	8	88	88	88
88	88	8	8	8	8	8	8	8	8	8	8	8	8	8	88	8	88	87	88	88	8	92	88	88	8	88	8	88	88	8	8	88	88	88
88	88	88	88	88	88	88	88	88	88	88	88	88	88	88	88	8	8	8	8	8	8	92	88	88	8	8	8	88	88	8	8	88	88	88 
99	99	99	99	99	99	99	99	99	99	99	99	99	88	88	88  88	88	88	88	88	88	88	88	88	88	88	88	88	88	88	88  88  88  88
99	99	99	99	99	99	99	99	99	99	99	99	99  99	99	99	99	99	99	99	99	99	99	99	99	99  99	99	99	99  99	99	99	99  99
99	99	99	99	99	99	99	99	99	99	99	99	99  99	99	99	99	99	99	99	99	99	99	99	99	99  99	99	99	99  99	99	99	99  99
99	99	99	99	99	99	99	99	99	99	99	99	99  99	99	99	99	99	99	99	99	99	99	99	99	99  99	99	99	99  99	99	99	99  99
99	99	99	99	99	99	99	99	99	99	99	99	99  99	99	99	99	99	99	99	99	99	99	99	99	99  99	99	99	99  99	99	99	99  99
99	99	99	99	99	99	99	99	99	99	99	99	99  99	99	99	99	99	99	99	99	99	99	99	99	99  99	99	99	99  99	99	99	99  99
99 99  99  99  99  99  99 13    19  19  19  19  19  19  19  19  19  19  18  19  16  99  99  99  99  99  99  99  99  99  99  99  99  99  99  
99 99  99  99  99  99  99 21 18 18  18  18   18 18 18 18 18 18 18 18 22 99  99  99  99  99  99  99  99  99  99  99  99  99  99  
99 99  99  99  99  99  99 21 18  18 18  18   18 18 18 18 18 18 18 18 22 99  99  99  99  99  99  99  99  99  99  99  99  99  99  
99 99  99  99  99  99  99 21 18  18 18  18   18 18 18 18 18 18 18 18 22 99  99  99  99  99  99  99  99  99  99  99  99  99  99  
99 99  99  99  99  99  99 21  18 18 18  18   18 18 18 18 18 18 18 18 22 99  99  99  99  99  99  99  99  99  99  99  99  99  99  
99 99  99  99  99  99  99 21  18 18 18  18   18 18 18 18 18 18 18 18 22 99  99  99  99  99  99  99  99  99  99  99  99  99  99  
99 99  99  99  99  99  99 21  18 18 18  18   18 18 18 18 18 18 18 18 22 99  99  99  99  99  99  99  99  99  99  99  99  99  99  
99 99  99  99  99  99  99 21 18  18 18  18   18 18 18 18 18 18 18 18 22 99  99  99  99  99  99  99  99  99  99  99  99  99  99  
99 99  99  99  99  99  99 21 18  18 18  18   18 18 18 18 18 18 18 18 22 99  99  99  99  99  99  99  99  99  99  99  99  99  99  
99 99  99  99  99  99  99 21 18  18 18  18   18 18 18 18 18 18 18 18 22 99  99  99  99  99  99  99  99  99  99  99  99  99  99  
99 99  99  99  99  99  99 14 20 20  20  20   20 20 20 20 20 20 20 20 17 99  99  99  99  99  99  99  99  99  99  99  99  99  99  